tras = después
trasera: rear (e.g., "rear window")
pareja: couple
sujetar: hold
sujeta: liable, amenable
cirugía: surgery
tratar: treat
estar tratando de: to try
se trata de: it is about
por dentro: inside
por tal motivo: for this reason
costilla: rib
suerte: luck
ánimo: courage, encouragement
averiguar: to find out
milagro: miracle
disparar: to shoot
disparo: shot, shooting 
fallecer: to die 
acercarse: to approach
sospechoso: suspect
pese a que: although
cometer: to commit
trasladar: to move
debido a: because of
acabar: to finish
forcejeo: struggle
sí mismo: himself, itself
campana: bell
campaña: bell
lo cierto es que: the truth is
carrera: race (or carreer)
ya que: since, insomuch as
giro inesperado: unexpected turn
desempeño: performance
postular: postulate
ola: wave
agregar: add
agrandar: enlarge
atreverse: to dare
clave: key
aquejan: afflicting
derrota: defeat
aplastante: overwhelming

Estoy muy felíz que nu familia y yo hemos tenidos todo esto buena suerte. Hay muchas personas en mi vida que tienen mucho ánimo, 
